XXXXXXXXXXXXXXXXXXXXXXXXXXXXXXXXXXXX0000
000000000000000X00000000000X000000000000
000000000000000X00000000000X000000000000
000000000000000X00000000000X000000000000
XXXXXXXXXXXX000XXXXX000X000XXXXXXXXX000X
00000000000X0000000X000X000X00000000000X
00000000000X0000000X000X000X00000000000X
00000000000X0000000X000X000X00000000000X
XXXX000XXXXXXXXXXXXXXXXX000X000X000XXXXX
00000000000X0000000X0000000X000X0000000X
00000000000X0000000X0000000X000X0000000X
00000000000X0000000X0000000X000X0000000X
000XXXXX000XXXXX000XXXXX000XXXXX000XXXXX
000X0000000X000X0000000X000X00000000000X
000X0000000X000X0000000X000X00000000000X
000X0000000X000X0000000X000X00000000000X
XXXX000XXXXX000XXXXX000X000XXXXXXXXXXXXX
0000000X0000000000000000000X00000000000X
0000000X0000000000000000000X00000000000X
0000000X0000000000000000000X00000000000X
XXXXXXXX000XXXXX000X000XXXXXXXXX000X000X
00000000000X0000000X000000000000000X000X
00000000000X0000000X000000000000000X000X
00000000000X0000000X000000000000000X000X
