XXXXXXXXXXXXXXXXXXXXXXXXXXXXXXXXXXXX0000
00000000000X00000000000X0000000X000X0000
00000000000X00000000000X0000000X000X0000
00000000000X00000000000X0000000X000X0000
000XXXXX000XXXXX000X000X000XXXXX000X000X
0000000000000000000X00000000000X0000000X
0000000000000000000X00000000000X0000000X
0000000000000000000X00000000000X0000000X
000XXXXX000XXXXX000XXXXXXXXX000X000XXXXX
000X0000000X000X000X0000000X00000000000X
000X0000000X000X000X0000000X00000000000X
000X0000000X000X000X0000000X00000000000X
000XXXXX000X000X000XXXXX000XXXXXXXXXXXXX
0000000X000X0000000X00000000000X0000000X
0000000X000X0000000X00000000000X0000000X
0000000X000X0000000X00000000000X0000000X
000XXXXXXXXXXXXXXXXX000XXXXXXXXXXXXX000X
000000000000000X00000000000X00000000000X
000000000000000X00000000000X00000000000X
000000000000000X00000000000X00000000000X
000X000XXXXXXXXX000X000XXXXX000XXXXX000X
000X000000000000000X000000000000000X000X
000X000000000000000X000000000000000X000X
000X000000000000000X000000000000000X000X
