XXXXXXXXXXXXXXXXXXXXXXXXXXXXXXXXXXXX0000
00000000000X0000000X0000000X000000000000
00000000000X0000000X0000000X000000000000
00000000000X0000000X0000000X000000000000
XXXX000XXXXX000XXXXX000XXXXXXXXXXXXXXXXX
000X000X0000000X000X000X000X000X0000000X
000X000X0000000X000X000X000X000X0000000X
000X000X0000000X000X000X000X000X0000000X
000XXXXX000XXXXX000X000XXXXX000XXXXXXXXX
00000000000X0000000X000X0000000X0000000X
00000000000X0000000X000X0000000X0000000X
00000000000X0000000X000X0000000X0000000X
000XXXXXXXXX000XXXXX000X000XXXXX000X000X
0000000X0000000X00000000000X0000000X000X
0000000X0000000X00000000000X0000000X000X
0000000X0000000X00000000000X0000000X000X
XXXX000X000XXXXX000XXXXX000X000XXXXXXXXX
000X000X000X00000000000X000X00000000000X
000X000X000X00000000000X000X00000000000X
000X000X000X00000000000X000X00000000000X
XXXX000XXXXX000XXXXX000XXXXX000X000XXXXX
000000000000000X000000000000000X000X000X
000000000000000X000000000000000X000X000X
000000000000000X000000000000000X000X000X
