XXXXXXXXXXXXXXXXXXXXXXXXXXXXXXXXXXXX0000
0000000X0000000000000000000X000X00000000
0000000X0000000000000000000X000X00000000
0000000X0000000000000000000X000X00000000
000X000X000XXXXX000X000XXXXX000XXXXX000X
000X00000000000X000X0000000X00000000000X
000X00000000000X000X0000000X00000000000X
000X00000000000X000X0000000X00000000000X
000XXXXX000XXXXX000XXXXXXXXXXXXX000XXXXX
0000000X000X000X000X000X0000000X0000000X
0000000X000X000X000X000X0000000X0000000X
0000000X000X000X000X000X0000000X0000000X
XXXXXXXX000X000XXXXX000XXXXX000X000XXXXX
00000000000X0000000X0000000X00000000000X
00000000000X0000000X0000000X00000000000X
00000000000X0000000X0000000X00000000000X
XXXXXXXXXXXX000XXXXXXXXX000X000X000X000X
000X00000000000X0000000X000X000X000X000X
000X00000000000X0000000X000X000X000X000X
000X00000000000X0000000X000X000X000X000X
XXXX000X000XXXXX000X000X000X000XXXXX000X
0000000X00000000000X0000000X00000000000X
0000000X00000000000X0000000X00000000000X
0000000X00000000000X0000000X00000000000X
