XXXXXXXXXXXXXXXXXXXXXXXXXXXXXXXXXXXX0000
00000000000X0000000X000X0000000000000000
00000000000X0000000X000X0000000000000000
00000000000X0000000X000X0000000000000000
XXXX000X000XXXXX000X000XXXXX000XXXXXXXXX
0000000X0000000X00000000000X000X000X000X
0000000X0000000X00000000000X000X000X000X
0000000X0000000X00000000000X000X000X000X
000XXXXX000X000XXXXX000X000X000X000X000X
000X0000000X000X0000000X000000000000000X
000X0000000X000X0000000X000000000000000X
000X0000000X000X0000000X000000000000000X
XXXXXXXXXXXX000X000XXXXX000X000XXXXXXXXX
000X0000000000000000000X000X0000000X000X
000X0000000000000000000X000X0000000X000X
000X0000000000000000000X000X0000000X000X
000X000X000XXXXX000XXXXXXXXXXXXX000X000X
0000000X000X000000000000000X00000000000X
0000000X000X000000000000000X00000000000X
0000000X000X000000000000000X00000000000X
000XXXXX000X000XXXXX000X000X000XXXXX000X
00000000000X000X000X000X00000000000X000X
00000000000X000X000X000X00000000000X000X
00000000000X000X000X000X00000000000X000X
