XXXXXXXXXXXXXXXXXXXXXXXXXXXXXXXXXXXX0000
000X00000000000X0000000000000000000X0000
000X00000000000X0000000000000000000X0000
000X00000000000X0000000000000000000X0000
000X000XXXXX000XXXXX000X000XXXXXXXXX000X
0000000X000X00000000000X000X00000000000X
0000000X000X00000000000X000X00000000000X
0000000X000X00000000000X000X00000000000X
000XXXXX000XXXXXXXXX000XXXXX000XXXXXXXXX
000X00000000000X000X00000000000X0000000X
000X00000000000X000X00000000000X0000000X
000X00000000000X000X00000000000X0000000X
000XXXXX000X000X000XXXXXXXXXXXXXXXXX000X
000X0000000X000X0000000X00000000000X000X
000X0000000X000X0000000X00000000000X000X
000X0000000X000X0000000X00000000000X000X
000X000X000XXXXX000X000X000X000XXXXX000X
0000000X00000000000X0000000X000X0000000X
0000000X00000000000X0000000X000X0000000X
0000000X00000000000X0000000X000X0000000X
000XXXXX000XXXXX000XXXXXXXXX000XXXXX000X
000X0000000X000000000000000000000000000X
000X0000000X000000000000000000000000000X
000X0000000X000000000000000000000000000X
