XXXXXXXXXXXXXXXXXXXXXXXXXXXXXXXXXXXX0000
000X000000000000000X0000000X000X00000000
000X000000000000000X0000000X000X00000000
000X000000000000000X0000000X000X00000000
000X000XXXXXXXXX000XXXXX000X000X000XXXXX
000000000000000X0000000X000X000X0000000X
000000000000000X0000000X000X000X0000000X
000000000000000X0000000X000X000X0000000X
XXXXXXXX000XXXXXXXXXXXXX000X000XXXXX000X
000000000000000X00000000000X0000000X000X
000000000000000X00000000000X0000000X000X
000000000000000X00000000000X0000000X000X
000XXXXXXXXXXXXX000XXXXX000X000XXXXX000X
00000000000X0000000X0000000X0000000X000X
00000000000X0000000X0000000X0000000X000X
00000000000X0000000X0000000X0000000X000X
XXXX000XXXXX000XXXXXXXXX000X000XXXXX000X
0000000X000000000000000X0000000X0000000X
0000000X000000000000000X0000000X0000000X
0000000X000000000000000X0000000X0000000X
000XXXXX000X000XXXXX000XXXXXXXXX000XXXXX
00000000000X0000000X0000000000000000000X
00000000000X0000000X0000000000000000000X
00000000000X0000000X0000000000000000000X
