XXXXXXXXXXXXXXXXXXXXXXXXXXXXXXXXXXXX0000
0000000X00000000000X00000000000X00000000
0000000X00000000000X00000000000X00000000
0000000X00000000000X00000000000X00000000
000XXXXX000XXXXX000XXXXXXXXX000XXXXX000X
00000000000X000X000X0000000X00000000000X
00000000000X000X000X0000000X00000000000X
00000000000X000X000X0000000X00000000000X
000X000XXXXXXXXX000X000X000XXXXX000XXXXX
000X0000000X000X0000000X000000000000000X
000X0000000X000X0000000X000000000000000X
000X0000000X000X0000000X000000000000000X
000X000X000X000XXXXXXXXXXXXX000XXXXXXXXX
000X000X0000000X0000000X0000000X000X000X
000X000X0000000X0000000X0000000X000X000X
000X000X0000000X0000000X0000000X000X000X
XXXX000XXXXXXXXXXXXXXXXXXXXXXXXX000XXXXX
0000000X000000000000000X000X00000000000X
0000000X000000000000000X000X00000000000X
0000000X000000000000000X000X00000000000X
000XXXXX000XXXXXXXXX000X000X000XXXXXXXXX
000X00000000000X000X0000000X00000000000X
000X00000000000X000X0000000X00000000000X
000X00000000000X000X0000000X00000000000X
