XXXXXXXXXXXXXXXXXXXXXXXXXXXXXXXXXXXXXXXX
000000000000000X00000000000X000X0000000X
000000000000000X00000000000X000X0000000X
000000000000000X00000000000X000X0000000X
XXXX000XXXXX000XXXXX000XXXXX000XXXXX000X
0000000X0000000X00000000000X000X0000000X
0000000X0000000X00000000000X000X0000000X
0000000X0000000X00000000000X000X0000000X
000X000XXXXX000X000XXXXX000X000XXXXXXXXX
000X0000000X0000000X0000000X000X0000000X
000X0000000X0000000X0000000X000X0000000X
000X0000000X0000000X0000000X000X0000000X
XXXX000XXXXXXXXXXXXXXXXXXXXX000XXXXXXXXX
0000000X000X000X000X000X000000000000000X
0000000X000X000X000X000X000000000000000X
0000000X000X000X000X000X000000000000000X
000XXXXX000XXXXX000XXXXX000XXXXXXXXXXXXX
000X00000000000X00000000000X00000000000X
000X00000000000X00000000000X00000000000X
000X00000000000X00000000000X00000000000X
000X000XXXXX000X000XXXXXXXXX000X000XXXXX
000X000X000X00000000000X0000000X000X000X
000X000X000X00000000000X0000000X000X000X
000X000X000X00000000000X0000000X000X000X
