XXXXXXXXXXXXXXXXXXXXXXXXXXXXXXXXXXXXXXXX
000X000X00000000000X00000000000X0000000X
000X000X00000000000X00000000000X0000000X
000X000X00000000000X00000000000X0000000X
000X000XXXXX000XXXXX000XXXXXXXXX000XXXXX
000X0000000X000X000X0000000X000X0000000X
000X0000000X000X000X0000000X000X0000000X
000X0000000X000X000X0000000X000X0000000X
000XXXXXXXXX000XXXXX000XXXXX000X000XXXXX
0000000X00000000000X000X0000000X0000000X
0000000X00000000000X000X0000000X0000000X
0000000X00000000000X000X0000000X0000000X
XXXXXXXXXXXXXXXXXXXXXXXXXXXXXXXXXXXXXXXX
0000000X000X000X000X000000000000000X000X
0000000X000X000X000X000000000000000X000X
0000000X000X000X000X000000000000000X000X
000X000X000XXXXX000XXXXX000X000XXXXX000X
000X000X00000000000X000X000X000X0000000X
000X000X00000000000X000X000X000X0000000X
000X000X00000000000X000X000X000X0000000X
000X000XXXXXXXXX000XXXXX000X000XXXXX000X
000X00000000000X000X000000000000000X000X
000X00000000000X000X000000000000000X000X
000X00000000000X000X000000000000000X000X
