XXXXXXXXXXXXXXXXXXXXXXXXXXXXXXXXXXXX0000
00000000000X0000000X00000000000X00000000
00000000000X0000000X00000000000X00000000
00000000000X0000000X00000000000X00000000
XXXXXXXX000XXXXX000X000XXXXX000X000XXXXX
000X0000000X0000000X0000000X0000000X000X
000X0000000X0000000X0000000X0000000X000X
000X0000000X0000000X0000000X0000000X000X
000X000XXXXX000X000XXXXX000XXXXXXXXXXXXX
0000000X0000000X00000000000X000X0000000X
0000000X0000000X00000000000X000X0000000X
0000000X0000000X00000000000X000X0000000X
XXXX000X000XXXXXXXXX000XXXXX000X000XXXXX
000X000X0000000X000X0000000X00000000000X
000X000X0000000X000X0000000X00000000000X
000X000X0000000X000X0000000X00000000000X
000X000X000X000XXXXXXXXXXXXX000XXXXXXXXX
00000000000X0000000X00000000000X0000000X
00000000000X0000000X00000000000X0000000X
00000000000X0000000X00000000000X0000000X
000XXXXX000XXXXX000XXXXX000X000X000X000X
0000000X000X000000000000000X0000000X000X
0000000X000X000000000000000X0000000X000X
0000000X000X000000000000000X0000000X000X
