XXXXXXXXXXXXXXXXXXXXXXXXXXXXXXXXXXXXXXXX
000X0000000X000X00000000000X0000000X000X
000X0000000X000X00000000000X0000000X000X
000X0000000X000X00000000000X0000000X000X
XXXX000X000XXXXX000X000XXXXX000XXXXX000X
0000000X00000000000X0000000X000X0000000X
0000000X00000000000X0000000X000X0000000X
0000000X00000000000X0000000X000X0000000X
XXXX000XXXXX000XXXXXXXXX000XXXXX000XXXXX
00000000000X0000000X000X00000000000X000X
00000000000X0000000X000X00000000000X000X
00000000000X0000000X000X00000000000X000X
000X000XXXXXXXXX000X000XXXXXXXXXXXXX000X
000X000X000X000X000X00000000000X0000000X
000X000X000X000X000X00000000000X0000000X
000X000X000X000X000X00000000000X0000000X
000X000XXXXX000XXXXX000XXXXX000X000XXXXX
0000000X00000000000X0000000X0000000X000X
0000000X00000000000X0000000X0000000X000X
0000000X00000000000X0000000X0000000X000X
000XXXXX000XXXXX000XXXXX000XXXXX000X000X
000X0000000X000X000X0000000X00000000000X
000X0000000X000X000X0000000X00000000000X
000X0000000X000X000X0000000X00000000000X
