XXXXXXXXXXXXXXXXXXXXXXXXXXXXXXXXXXXX0000
000000000000000X00000000000X000X00000000
000000000000000X00000000000X000X00000000
000000000000000X00000000000X000X00000000
XXXX000X000XXXXX000XXXXX000X000X000XXXXX
0000000X000X0000000X000X0000000X0000000X
0000000X000X0000000X000X0000000X0000000X
0000000X000X0000000X000X0000000X0000000X
XXXX000XXXXX000XXXXX000XXXXXXXXXXXXX000X
000000000000000X000000000000000X000X000X
000000000000000X000000000000000X000X000X
000000000000000X000000000000000X000X000X
XXXX000XXXXXXXXXXXXX000XXXXXXXXX000X000X
000X000X0000000X0000000X000X0000000X000X
000X000X0000000X0000000X000X0000000X000X
000X000X0000000X0000000X000X0000000X000X
000X000X000XXXXX000X000X000X000XXXXX000X
000000000000000X000X0000000X00000000000X
000000000000000X000X0000000X00000000000X
000000000000000X000X0000000X00000000000X
XXXX000XXXXX000X000X000XXXXX000XXXXXXXXX
0000000X00000000000X0000000000000000000X
0000000X00000000000X0000000000000000000X
0000000X00000000000X0000000000000000000X
