XXXXXXXXXXXXXXXXXXXXXXXXXXXXXXXXXXXX0000
000X000X000X000X00000000000X0000000X0000
000X000X000X000X00000000000X0000000X0000
000X000X000X000X00000000000X0000000X0000
XXXX000X000XXXXX000XXXXX000XXXXXXXXX000X
000X000X00000000000X000X000X000X0000000X
000X000X00000000000X000X000X000X0000000X
000X000X00000000000X000X000X000X0000000X
000XXXXX000XXXXX000XXXXX000XXXXX000XXXXX
00000000000X000X0000000X0000000X0000000X
00000000000X000X0000000X0000000X0000000X
00000000000X000X0000000X0000000X0000000X
XXXX000XXXXXXXXXXXXX000XXXXXXXXXXXXX000X
0000000X0000000X000X000000000000000X000X
0000000X0000000X000X000000000000000X000X
0000000X0000000X000X000000000000000X000X
XXXX000X000XXXXX000X000XXXXX000XXXXX000X
0000000X000X00000000000X000X000X0000000X
0000000X000X00000000000X000X000X0000000X
0000000X000X00000000000X000X000X0000000X
000XXXXXXXXX000XXXXX000XXXXXXXXX000XXXXX
00000000000X000X000X000000000000000X000X
00000000000X000X000X000000000000000X000X
00000000000X000X000X000000000000000X000X
