XXXXXXXXXXXXXXXXXXXXXXXXXXXXXXXXXXXX0000
00000000000X00000000000X0000000X00000000
00000000000X00000000000X0000000X00000000
00000000000X00000000000X0000000X00000000
000X000XXXXX000XXXXX000X000XXXXX000XXXXX
000X000X00000000000X000X000X000X0000000X
000X000X00000000000X000X000X000X0000000X
000X000X00000000000X000X000X000X0000000X
000XXXXX000XXXXXXXXXXXXX000X000XXXXX000X
000000000000000X00000000000X0000000X000X
000000000000000X00000000000X0000000X000X
000000000000000X00000000000X0000000X000X
000X000XXXXX000X000XXXXX000X000XXXXX000X
000X000X0000000X000X000X000X000X0000000X
000X000X0000000X000X000X000X000X0000000X
000X000X0000000X000X000X000X000X0000000X
XXXX000X000XXXXX000XXXXX000XXXXX000XXXXX
000X000X000X00000000000X00000000000X000X
000X000X000X00000000000X00000000000X000X
000X000X000X00000000000X00000000000X000X
XXXX000XXXXX000XXXXX000XXXXXXXXXXXXXXXXX
000000000000000X000X000X000X000X000X000X
000000000000000X000X000X000X000X000X000X
000000000000000X000X000X000X000X000X000X
