XXXXXXXXXXXXXXXXXXXXXXXXXXXXXXXXXXXXXXXX
0000000000000000000000000000000X0000000X
0000000000000000000000000000000X0000000X
0000000000000000000000000000000X0000000X
000X000X000XXXXXXXXXXXXXXXXX000XXXXXXXXX
000X000X000X000000000000000X00000000000X
000X000X000X000000000000000X00000000000X
000X000X000X000000000000000X00000000000X
XXXX000X000XXXXXXXXXXXXX000XXXXXXXXX000X
0000000X000000000000000X000X0000000X000X
0000000X000000000000000X000X0000000X000X
0000000X000000000000000X000X0000000X000X
000XXXXX000XXXXXXXXXXXXX000XXXXX000X000X
0000000X000X000000000000000X0000000X000X
0000000X000X000000000000000X0000000X000X
0000000X000X000000000000000X0000000X000X
000XXXXX000X000XXXXXXXXXXXXXXXXX000X000X
0000000X000X000X000000000000000X0000000X
0000000X000X000X000000000000000X0000000X
0000000X000X000X000000000000000X0000000X
XXXXXXXX000X000XXXXXXXXXXXXX000X000XXXXX
00000000000X000000000000000X00000000000X
00000000000X000000000000000X00000000000X
00000000000X000000000000000X00000000000X
