XXXXXXXXXXXXXXXXXXXXXXXXXXXXXXXXXXXX0000
0000000X000X00000000000X000X000000000000
0000000X000X00000000000X000X000000000000
0000000X000X00000000000X000X000000000000
XXXX000XXXXX000XXXXX000X000XXXXX000XXXXX
000000000000000X000X000000000000000X000X
000000000000000X000X000000000000000X000X
000000000000000X000X000000000000000X000X
XXXX000XXXXXXXXXXXXX000XXXXXXXXX000XXXXX
000X0000000X0000000X00000000000X0000000X
000X0000000X0000000X00000000000X0000000X
000X0000000X0000000X00000000000X0000000X
XXXXXXXX000XXXXXXXXXXXXX000XXXXX000XXXXX
00000000000X0000000X00000000000X0000000X
00000000000X0000000X00000000000X0000000X
00000000000X0000000X00000000000X0000000X
000X000XXXXXXXXXXXXXXXXX000XXXXX000XXXXX
000X000X0000000X00000000000X000X0000000X
000X000X0000000X00000000000X000X0000000X
000X000X0000000X00000000000X000X0000000X
000XXXXX000XXXXX000XXXXXXXXXXXXX000XXXXX
000X000X000X000X000X00000000000X000X000X
000X000X000X000X000X00000000000X000X000X
000X000X000X000X000X00000000000X000X000X
