XXXXXXXXXXXXXXXXXXXXXXXXXXXXXXXXXXXX0000
00000000000X000X000X000X0000000X00000000
00000000000X000X000X000X0000000X00000000
00000000000X000X000X000X0000000X00000000
XXXXXXXX000XXXXX000X000XXXXXXXXX000XXXXX
000X0000000X000X0000000X000X00000000000X
000X0000000X000X0000000X000X00000000000X
000X0000000X000X0000000X000X00000000000X
XXXX000XXXXX000XXXXX000X000XXXXXXXXXXXXX
0000000000000000000000000000000X0000000X
0000000000000000000000000000000X0000000X
0000000000000000000000000000000X0000000X
XXXX000XXXXXXXXX000XXXXXXXXXXXXXXXXX000X
000X0000000X000X0000000X000X0000000X000X
000X0000000X000X0000000X000X0000000X000X
000X0000000X000X0000000X000X0000000X000X
XXXX000XXXXX000XXXXXXXXXXXXX000XXXXX000X
0000000X0000000X0000000X0000000X000X000X
0000000X0000000X0000000X0000000X000X000X
0000000X0000000X0000000X0000000X000X000X
000XXXXX000XXXXXXXXX000XXXXXXXXX000X000X
000X00000000000X000X000000000000000X000X
000X00000000000X000X000000000000000X000X
000X00000000000X000X000000000000000X000X
