XXXXXXXXXXXXXXXXXXXXXXXXXXXXXXXXXXXX0000
0000000X0000000000000000000X000000000000
0000000X0000000000000000000X000000000000
0000000X0000000000000000000X000000000000
XXXX000X000XXXXXXXXX000XXXXX000XXXXXXXXX
0000000000000000000X0000000000000000000X
0000000000000000000X0000000000000000000X
0000000000000000000X0000000000000000000X
XXXX000XXXXXXXXX000XXXXXXXXXXXXXXXXX000X
000X000X000X000X0000000X000X000X000X000X
000X000X000X000X0000000X000X000X000X000X
000X000X000X000X0000000X000X000X000X000X
000X000X000X000X000X000X000X000X000XXXXX
0000000X0000000X000X000X000000000000000X
0000000X0000000X000X000X000000000000000X
0000000X0000000X000X000X000000000000000X
XXXX000XXXXX000X000XXXXXXXXX000XXXXXXXXX
0000000X0000000X00000000000X000X0000000X
0000000X0000000X00000000000X000X0000000X
0000000X0000000X00000000000X000X0000000X
000XXXXX000XXXXX000XXXXXXXXX000X000X000X
000000000000000X0000000000000000000X000X
000000000000000X0000000000000000000X000X
000000000000000X0000000000000000000X000X
