XXXXXXXXXXXXXXXXXXXXXXXXXXXXXXXXXXXX0000
000000000000000X0000000X000X0000000X0000
000000000000000X0000000X000X0000000X0000
000000000000000X0000000X000X0000000X0000
000XXXXXXXXX000X000XXXXX000XXXXX000X000X
0000000X00000000000X0000000X0000000X000X
0000000X00000000000X0000000X0000000X000X
0000000X00000000000X0000000X0000000X000X
000X000XXXXXXXXXXXXXXXXX000X000XXXXX000X
000X00000000000X000X00000000000X000X000X
000X00000000000X000X00000000000X000X000X
000X00000000000X000X00000000000X000X000X
XXXX000XXXXX000X000XXXXX000XXXXX000X000X
0000000X000X00000000000X000X0000000X000X
0000000X000X00000000000X000X0000000X000X
0000000X000X00000000000X000X0000000X000X
XXXX000XXXXXXXXXXXXXXXXX000XXXXXXXXX000X
000X000X00000000000X0000000X00000000000X
000X000X00000000000X0000000X00000000000X
000X000X00000000000X0000000X00000000000X
XXXXXXXX000XXXXX000X000X000XXXXXXXXXXXXX
000X000X000X000X000X000X00000000000X000X
000X000X000X000X000X000X00000000000X000X
000X000X000X000X000X000X00000000000X000X
