XXXXXXXXXXXXXXXXXXXXXXXXXXXXXXXXXXXX0000
0000000X000000000000000X0000000000000000
0000000X000000000000000X0000000000000000
0000000X000000000000000X0000000000000000
000X000X000XXXXXXXXX000XXXXX000XXXXXXXXX
000X000000000000000X00000000000X0000000X
000X000000000000000X00000000000X0000000X
000X000000000000000X00000000000X0000000X
000XXXXXXXXXXXXXXXXXXXXXXXXXXXXXXXXX000X
000X00000000000X000000000000000X000X000X
000X00000000000X000000000000000X000X000X
000X00000000000X000000000000000X000X000X
000XXXXXXXXX000XXXXX000XXXXX000X000X000X
0000000000000000000X0000000X00000000000X
0000000000000000000X0000000X00000000000X
0000000000000000000X0000000X00000000000X
000X000X000XXXXX000XXXXX000XXXXXXXXXXXXX
000X000X0000000X000000000000000X0000000X
000X000X0000000X000000000000000X0000000X
000X000X0000000X000000000000000X0000000X
000XXXXXXXXX000XXXXXXXXX000X000X000XXXXX
000X00000000000X00000000000X00000000000X
000X00000000000X00000000000X00000000000X
000X00000000000X00000000000X00000000000X
