XXXXXXXXXXXXXXXXXXXXXXXXXXXXXXXXXXXX0000
000X000000000000000X000X00000000000X0000
000X000000000000000X000X00000000000X0000
000X000000000000000X000X00000000000X0000
XXXX000XXXXXXXXX000XXXXX000X000XXXXX000X
0000000X0000000X00000000000X00000000000X
0000000X0000000X00000000000X00000000000X
0000000X0000000X00000000000X00000000000X
000XXXXX000X000X000XXXXX000XXXXXXXXX000X
00000000000X0000000X000X0000000X0000000X
00000000000X0000000X000X0000000X0000000X
00000000000X0000000X000X0000000X0000000X
XXXX000X000XXXXX000XXXXX000XXXXX000XXXXX
0000000X000X000X000X000000000000000X000X
0000000X000X000X000X000000000000000X000X
0000000X000X000X000X000000000000000X000X
000XXXXXXXXX000XXXXXXXXX000X000XXXXXXXXX
000X000X000X000X000X0000000X000X0000000X
000X000X000X000X000X0000000X000X0000000X
000X000X000X000X000X0000000X000X0000000X
000XXXXX000XXXXX000XXXXXXXXX000XXXXX000X
000X000000000000000X0000000X0000000X000X
000X000000000000000X0000000X0000000X000X
000X000000000000000X0000000X0000000X000X
