XXXXXXXXXXXXXXXXXXXXXXXXXXXXXXXXXXXXXXXX
0000000X000X00000000000000000000000X000X
0000000X000X00000000000000000000000X000X
0000000X000X00000000000000000000000X000X
000XXXXX000X000X000XXXXX000XXXXXXXXX000X
0000000X0000000X000X0000000X0000000X000X
0000000X0000000X000X0000000X0000000X000X
0000000X0000000X000X0000000X0000000X000X
000X000X000XXXXXXXXXXXXXXXXX000XXXXX000X
000X0000000X0000000X00000000000X0000000X
000X0000000X0000000X00000000000X0000000X
000X0000000X0000000X00000000000X0000000X
XXXX000X000X000XXXXX000XXXXXXXXXXXXX000X
0000000X000X000X0000000X00000000000X000X
0000000X000X000X0000000X00000000000X000X
0000000X000X000X0000000X00000000000X000X
XXXX000XXXXX000X000XXXXXXXXX000X000XXXXX
0000000X0000000000000000000X000X0000000X
0000000X0000000000000000000X000X0000000X
0000000X0000000000000000000X000X0000000X
XXXXXXXX000XXXXX000X000XXXXX000X000X000X
00000000000X000X000X00000000000X000X000X
00000000000X000X000X00000000000X000X000X
00000000000X000X000X00000000000X000X000X
