XXXXXXXXXXXXXXXXXXXXXXXXXXXXXXXXXXXX0000
00000000000X0000000X000X0000000X00000000
00000000000X0000000X000X0000000X00000000
00000000000X0000000X000X0000000X00000000
000XXXXX000X000X000XXXXX000XXXXXXXXX000X
0000000X0000000X000X0000000X000X0000000X
0000000X0000000X000X0000000X000X0000000X
0000000X0000000X000X0000000X000X0000000X
XXXX000X000XXXXX000X000XXXXXXXXXXXXXXXXX
000X0000000X000X0000000X000X0000000X000X
000X0000000X000X0000000X000X0000000X000X
000X0000000X000X0000000X000X0000000X000X
XXXXXXXX000X000XXXXXXXXX000X000XXXXX000X
000X00000000000X000X000X0000000X0000000X
000X00000000000X000X000X0000000X0000000X
000X00000000000X000X000X0000000X0000000X
XXXX000XXXXXXXXX000XXXXX000XXXXX000XXXXX
0000000X000X0000000X00000000000X0000000X
0000000X000X0000000X00000000000X0000000X
0000000X000X0000000X00000000000X0000000X
000X000XXXXX000X000XXXXX000XXXXXXXXX000X
000X000X0000000X000X00000000000X000X000X
000X000X0000000X000X00000000000X000X000X
000X000X0000000X000X00000000000X000X000X
