XXXXXXXXXXXXXXXXXXXXXXXXXXXXXXXXXXXX0000
0000000000000000000X000X00000000000X0000
0000000000000000000X000X00000000000X0000
0000000000000000000X000X00000000000X0000
XXXX000XXXXXXXXX000X000X000X000XXXXX000X
000X00000000000X0000000X000X000X0000000X
000X00000000000X0000000X000X000X0000000X
000X00000000000X0000000X000X000X0000000X
XXXX000X000XXXXXXXXX000X000XXXXX000XXXXX
0000000X00000000000X000X00000000000X000X
0000000X00000000000X000X00000000000X000X
0000000X00000000000X000X00000000000X000X
000XXXXXXXXXXXXXXXXXXXXX000XXXXXXXXX000X
000X000X00000000000X0000000X00000000000X
000X000X00000000000X0000000X00000000000X
000X000X00000000000X0000000X00000000000X
000XXXXX000XXXXX000X000XXXXXXXXX000XXXXX
00000000000X000X0000000X000000000000000X
00000000000X000X0000000X000000000000000X
00000000000X000X0000000X000000000000000X
XXXXXXXX000X000X000XXXXX000XXXXX000XXXXX
00000000000X000X00000000000X000X000X000X
00000000000X000X00000000000X000X000X000X
00000000000X000X00000000000X000X000X000X
