XXXXXXXXXXXXXXXXXXXXXXXXXXXXXXXXXXXX0000
00000000000000000000000X000X000000000000
00000000000000000000000X000X000000000000
00000000000000000000000X000X000000000000
000XXXXXXXXX000XXXXX000X000X000X000XXXXX
0000000X000X0000000X00000000000X0000000X
0000000X000X0000000X00000000000X0000000X
0000000X000X0000000X00000000000X0000000X
XXXX000X000X000XXXXX000XXXXXXXXXXXXX000X
00000000000X0000000X000X000X0000000X000X
00000000000X0000000X000X000X0000000X000X
00000000000X0000000X000X000X0000000X000X
000XXXXXXXXXXXXX000XXXXXXXXX000XXXXX000X
0000000X000X000X000000000000000X0000000X
0000000X000X000X000000000000000X0000000X
0000000X000X000X000000000000000X0000000X
000XXXXX000XXXXXXXXX000X000XXXXXXXXX000X
000000000000000X0000000X000X0000000X000X
000000000000000X0000000X000X0000000X000X
000000000000000X0000000X000X0000000X000X
000XXXXX000X000X000XXXXXXXXX000XXXXX000X
000X000X000X000X00000000000X00000000000X
000X000X000X000X00000000000X00000000000X
000X000X000X000X00000000000X00000000000X
