XXXXXXXXXXXXXXXXXXXXXXXXXXXXXXXXXXXX0000
00000000000X000X00000000000X000X00000000
00000000000X000X00000000000X000X00000000
00000000000X000X00000000000X000X00000000
000XXXXX000X000X000XXXXX000X000X000XXXXX
0000000X00000000000X000X000X00000000000X
0000000X00000000000X000X000X00000000000X
0000000X00000000000X000X000X00000000000X
XXXX000XXXXXXXXXXXXX000XXXXX000XXXXX000X
00000000000X000X000X00000000000X000X000X
00000000000X000X000X00000000000X000X000X
00000000000X000X000X00000000000X000X000X
XXXXXXXX000X000X000X000XXXXXXXXX000X000X
00000000000X0000000X000000000000000X000X
00000000000X0000000X000000000000000X000X
00000000000X0000000X000000000000000X000X
XXXX000X000XXXXX000XXXXXXXXXXXXXXXXX000X
0000000X00000000000X000000000000000X000X
0000000X00000000000X000000000000000X000X
0000000X00000000000X000000000000000X000X
XXXXXXXX000X000X000X000X000XXXXX000X000X
00000000000X000X0000000X0000000X0000000X
00000000000X000X0000000X0000000X0000000X
00000000000X000X0000000X0000000X0000000X
