XXXXXXXXXXXXXXXXXXXXXXXXXXXXXXXXXXXX0000
000X0000000X00000000000X00000000000X0000
000X0000000X00000000000X00000000000X0000
000X0000000X00000000000X00000000000X0000
000X000X000X000X000X000X000XXXXX000X000X
0000000X0000000X000X000X0000000X0000000X
0000000X0000000X000X000X0000000X0000000X
0000000X0000000X000X000X0000000X0000000X
XXXX000X000XXXXXXXXX000XXXXX000X000XXXXX
0000000X0000000X000X0000000X00000000000X
0000000X0000000X000X0000000X00000000000X
0000000X0000000X000X0000000X00000000000X
XXXX000XXXXXXXXX000X000XXXXX000XXXXXXXXX
000X00000000000X000X000X000000000000000X
000X00000000000X000X000X000000000000000X
000X00000000000X000X000X000000000000000X
000X000XXXXX000X000XXXXX000XXXXX000XXXXX
0000000X0000000X000X0000000X000X0000000X
0000000X0000000X000X0000000X000X0000000X
0000000X0000000X000X0000000X000X0000000X
000XXXXX000XXXXX000XXXXXXXXX000X000X000X
000X000000000000000X00000000000X000X000X
000X000000000000000X00000000000X000X000X
000X000000000000000X00000000000X000X000X
