XXXXXXXXXXXXXXXXXXXXXXXXXXXXXXXXXXXX0000
000X0000000000000000000X000X000000000000
000X0000000000000000000X000X000000000000
000X0000000000000000000X000X000000000000
000XXXXX000XXXXX000XXXXX000XXXXX000XXXXX
000X0000000X0000000X00000000000X000X000X
000X0000000X0000000X00000000000X000X000X
000X0000000X0000000X00000000000X000X000X
000XXXXXXXXX000XXXXX000XXXXXXXXX000X000X
000000000000000X000X000X000X0000000X000X
000000000000000X000X000X000X0000000X000X
000000000000000X000X000X000X0000000X000X
XXXX000XXXXXXXXXXXXX000XXXXX000XXXXXXXXX
00000000000X0000000000000000000X0000000X
00000000000X0000000000000000000X0000000X
00000000000X0000000000000000000X0000000X
000XXXXXXXXX000XXXXXXXXX000XXXXX000XXXXX
000000000000000X000X000X000X00000000000X
000000000000000X000X000X000X00000000000X
000000000000000X000X000X000X00000000000X
000XXXXX000XXXXX000X000XXXXX000X000XXXXX
000X000X00000000000000000000000X000X000X
000X000X00000000000000000000000X000X000X
000X000X00000000000000000000000X000X000X
