XXXXXXXXXXXXXXXXXXXXXXXXXXXXXXXXXXXX0000
000000000000000X0000000X0000000X00000000
000000000000000X0000000X0000000X00000000
000000000000000X0000000X0000000X00000000
XXXX000XXXXX000X000X000X000X000XXXXX000X
00000000000X000X000X000X000X000X0000000X
00000000000X000X000X000X000X000X0000000X
00000000000X000X000X000X000X000X0000000X
XXXXXXXXXXXX000XXXXX000X000XXXXXXXXX000X
000000000000000X0000000000000000000X000X
000000000000000X0000000000000000000X000X
000000000000000X0000000000000000000X000X
000XXXXXXXXX000X000XXXXXXXXXXXXX000X000X
00000000000X000X000X000000000000000X000X
00000000000X000X000X000000000000000X000X
00000000000X000X000X000000000000000X000X
XXXXXXXX000XXXXX000XXXXXXXXX000X000X000X
0000000X000000000000000X0000000X0000000X
0000000X000000000000000X0000000X0000000X
0000000X000000000000000X0000000X0000000X
XXXX000X000XXXXX000XXXXXXXXXXXXX000XXXXX
00000000000X000X00000000000X0000000X000X
00000000000X000X00000000000X0000000X000X
00000000000X000X00000000000X0000000X000X
