XXXXXXXXXXXXXXXXXXXXXXXXXXXXXXXXXXXX0000
0000000X000X000X000000000000000X000X0000
0000000X000X000X000000000000000X000X0000
0000000X000X000X000000000000000X000X0000
XXXXXXXX000XXXXX000XXXXXXXXX000XXXXX000X
0000000X0000000000000000000X00000000000X
0000000X0000000000000000000X00000000000X
0000000X0000000000000000000X00000000000X
XXXX000X000XXXXX000X000X000XXXXXXXXX000X
000X0000000X000X000X000X0000000X0000000X
000X0000000X000X000X000X0000000X0000000X
000X0000000X000X000X000X0000000X0000000X
XXXXXXXX000X000X000XXXXXXXXX000XXXXXXXXX
00000000000X000X0000000X0000000X0000000X
00000000000X000X0000000X0000000X0000000X
00000000000X000X0000000X0000000X0000000X
000X000XXXXXXXXX000XXXXXXXXX000X000XXXXX
000X0000000X0000000X000X000X0000000X000X
000X0000000X0000000X000X000X0000000X000X
000X0000000X0000000X000X000X0000000X000X
000XXXXXXXXX000XXXXX000XXXXXXXXX000XXXXX
000X00000000000X000X0000000X0000000X000X
000X00000000000X000X0000000X0000000X000X
000X00000000000X000X0000000X0000000X000X
