XXXXXXXXXXXXXXXXXXXXXXXXXXXXXXXXXXXX0000
000000000000000X000X000X0000000000000000
000000000000000X000X000X0000000000000000
000000000000000X000X000X0000000000000000
XXXX000X000X000XXXXX000X000X000XXXXXXXXX
000X000X000X0000000X000X000X000X0000000X
000X000X000X0000000X000X000X000X0000000X
000X000X000X0000000X000X000X000X0000000X
XXXXXXXX000XXXXXXXXXXXXX000XXXXX000X000X
000X000000000000000X0000000X0000000X000X
000X000000000000000X0000000X0000000X000X
000X000000000000000X0000000X0000000X000X
XXXX000XXXXX000X000XXXXX000X000XXXXXXXXX
000X000X000X000X0000000X000X00000000000X
000X000X000X000X0000000X000X00000000000X
000X000X000X000X0000000X000X00000000000X
XXXX000XXXXXXXXXXXXXXXXX000X000XXXXX000X
000X00000000000X000000000000000X000X000X
000X00000000000X000000000000000X000X000X
000X00000000000X000000000000000X000X000X
XXXX000XXXXX000X000XXXXX000XXXXX000XXXXX
0000000X000X0000000X000000000000000X000X
0000000X000X0000000X000000000000000X000X
0000000X000X0000000X000000000000000X000X
