XXXXXXXXXXXXXXXXXXXXXXXXXXXXXXXXXXXX0000
0000000X000X000000000000000X0000000X0000
0000000X000X000000000000000X0000000X0000
0000000X000X000000000000000X0000000X0000
XXXX000X000X000XXXXX000XXXXX000X000X000X
0000000000000000000X0000000X000X0000000X
0000000000000000000X0000000X000X0000000X
0000000000000000000X0000000X000X0000000X
XXXX000XXXXXXXXXXXXXXXXX000XXXXXXXXXXXXX
00000000000X000X000X0000000000000000000X
00000000000X000X000X0000000000000000000X
00000000000X000X000X0000000000000000000X
XXXX000XXXXX000X000X000XXXXXXXXX000XXXXX
000X000X00000000000X0000000X00000000000X
000X000X00000000000X0000000X00000000000X
000X000X00000000000X0000000X00000000000X
000X000X000XXXXX000XXXXXXXXXXXXXXXXXXXXX
0000000X000X000000000000000000000000000X
0000000X000X000000000000000000000000000X
0000000X000X000000000000000000000000000X
000XXXXX000XXXXXXXXX000XXXXXXXXX000XXXXX
000X0000000X00000000000X000000000000000X
000X0000000X00000000000X000000000000000X
000X0000000X00000000000X000000000000000X
