XXXXXXXXXXXXXXXXXXXXXXXXXXXXXXXXXXXX0000
0000000000000000000X00000000000X00000000
0000000000000000000X00000000000X00000000
0000000000000000000X00000000000X00000000
000XXXXXXXXXXXXX000XXXXXXXXX000XXXXXXXXX
0000000X0000000X00000000000X00000000000X
0000000X0000000X00000000000X00000000000X
0000000X0000000X00000000000X00000000000X
000XXXXX000XXXXXXXXX000XXXXX000XXXXXXXXX
000X000000000000000X000X0000000X000X000X
000X000000000000000X000X0000000X000X000X
000X000000000000000X000X0000000X000X000X
000X000XXXXXXXXXXXXXXXXX000XXXXX000X000X
0000000X0000000X0000000X000000000000000X
0000000X0000000X0000000X000000000000000X
0000000X0000000X0000000X000000000000000X
XXXX000X000X000X000XXXXX000X000XXXXXXXXX
00000000000X0000000X0000000X00000000000X
00000000000X0000000X0000000X00000000000X
00000000000X0000000X0000000X00000000000X
000XXXXXXXXX000XXXXX000XXXXX000X000XXXXX
000X00000000000X0000000X0000000X0000000X
000X00000000000X0000000X0000000X0000000X
000X00000000000X0000000X0000000X0000000X
