XXXXXXXXXXXXXXXXXXXXXXXXXXXXXXXXXXXXXXXX
000000000000000X000000000000000X000X000X
000000000000000X000000000000000X000X000X
000000000000000X000000000000000X000X000X
000X000X000XXXXX000X000XXXXXXXXX000X000X
000X000X000X0000000X000000000000000X000X
000X000X000X0000000X000000000000000X000X
000X000X000X0000000X000000000000000X000X
XXXX000XXXXX000XXXXXXXXX000XXXXXXXXX000X
0000000X0000000X0000000X00000000000X000X
0000000X0000000X0000000X00000000000X000X
0000000X0000000X0000000X00000000000X000X
000X000X000XXXXX000XXXXXXXXX000XXXXX000X
000X0000000X000X00000000000X0000000X000X
000X0000000X000X00000000000X0000000X000X
000X0000000X000X00000000000X0000000X000X
XXXX000XXXXXXXXX000XXXXX000XXXXX000X000X
000000000000000X000X00000000000X0000000X
000000000000000X000X00000000000X0000000X
000000000000000X000X00000000000X0000000X
000XXXX000XXXXXX000X000XXXXXXXXX000XXXXX
000X000000000000000X00000000000X0000000X
000X000000000000000X00000000000X0000000X
000X000000000000000X00000000000X0000000X
