XXXXXXXXXXXXXXXXXXXXXXXXXXXXXXXXXXXX0000
00000000000000000000000X000X000000000000
00000000000000000000000X000X000000000000
00000000000000000000000X000X000000000000
000XXXXXXXXX000X000XXXXX000XXXXX000XXXXX
000X0000000X000X0000000X000X000X000X000X
000X0000000X000X0000000X000X000X000X000X
000X0000000X000X0000000X000X000X000X000X
000XXXXX000X000XXXXXXXXX000X000X000X000X
0000000X000X0000000000000000000X0000000X
0000000X000X0000000000000000000X0000000X
0000000X000X0000000000000000000X0000000X
000XXXXX000XXXXXXXXXXXXXXXXX000XXXXX000X
000000000000000X00000000000X00000000000X
000000000000000X00000000000X00000000000X
000000000000000X00000000000X00000000000X
XXXX000XXXXXXXXX000X000X000X000XXXXXXXXX
00000000000X0000000X000X000X000X0000000X
00000000000X0000000X000X000X000X0000000X
00000000000X0000000X000X000X000X0000000X
000XXXXX000X000XXXXXXXXX000XXXXX000X000X
000X00000000000X0000000000000000000X000X
000X00000000000X0000000000000000000X000X
000X00000000000X0000000000000000000X000X
