XXXXXXXXXXXXXXXXXXXXXXXXXXXXXXXXXXXX0000
000000000000000X000X00000000000000000000
000000000000000X000X00000000000000000000
000000000000000X000X00000000000000000000
XXXX000X000X000X000XXXXX000XXXXXXXXX000X
0000000X000X00000000000X000X000X0000000X
0000000X000X00000000000X000X000X0000000X
0000000X000X00000000000X000X000X0000000X
000XXXXX000X000XXXXX000X000X000X000XXXXX
000X0000000X000X0000000X0000000X0000000X
000X0000000X000X0000000X0000000X0000000X
000X0000000X000X0000000X0000000X0000000X
XXXX000XXXXXXXXXXXXXXXXX000XXXXX000XXXXX
00000000000X0000000X0000000X00000000000X
00000000000X0000000X0000000X00000000000X
00000000000X0000000X0000000X00000000000X
000XXXXX000X000XXXXX000XXXXX000XXXXXXXXX
0000000X000X000X0000000X000000000000000X
0000000X000X000X0000000X000000000000000X
0000000X000X000X0000000X000000000000000X
000XXXXXXXXX000X000XXXXXXXXX000XXXXX000X
000X00000000000X000X000000000000000X000X
000X00000000000X000X000000000000000X000X
000X00000000000X000X000000000000000X000X
