XXXXXXXXXXXXXXXXXXXXXXXXXXXXXXXXXXXX0000
000X00000000000X0000000X0000000X000X0000
000X00000000000X0000000X0000000X000X0000
000X00000000000X0000000X0000000X000X0000
000X000X000XXXXX000X000X000XXXXX000X000X
0000000X00000000000X0000000X00000000000X
0000000X00000000000X0000000X00000000000X
0000000X00000000000X0000000X00000000000X
XXXXXXXX000XXXXXXXXXXXXXXXXXXXXXXXXX000X
00000000000000000000000X0000000X000X000X
00000000000000000000000X0000000X000X000X
00000000000000000000000X0000000X000X000X
XXXXXXXX000X000XXXXX000X000XXXXX000X000X
0000000X000X000X000X00000000000X0000000X
0000000X000X000X000X00000000000X0000000X
0000000X000X000X000X00000000000X0000000X
XXXX000XXXXX000X000XXXXX000XXXXX000XXXXX
0000000X0000000000000000000000000000000X
0000000X0000000000000000000000000000000X
0000000X0000000000000000000000000000000X
000XXXXX000XXXXXXXXXXXXX000X000XXXXX000X
000000000000000X00000000000X00000000000X
000000000000000X00000000000X00000000000X
000000000000000X00000000000X00000000000X
