XXXXXXXXXXXXXXXXXXXXXXXXXXXXXXXXXXXX0000
000X000X000X000X000X000X000X000000000000
000X000X000X000X000X000X000X000000000000
000X000X000X000X000X000X000X000000000000
XXXX000XXXXX000XXXXX000XXXXXXXXX000XXXXX
000X000000000000000X00000000000X0000000X
000X000000000000000X00000000000X0000000X
000X000000000000000X00000000000X0000000X
XXXX000XXXXXXXXX000XXXXX000XXXXXXXXX000X
0000000X000X0000000X000X000X000X000X000X
0000000X000X0000000X000X000X000X000X000X
0000000X000X0000000X000X000X000X000X000X
XXXX000XXXXXXXXX000XXXXXXXXXXXXX000X000X
0000000X000X000X0000000X000X000X0000000X
0000000X000X000X0000000X000X000X0000000X
0000000X000X000X0000000X000X000X0000000X
000XXXXX000XXXXXXXXX000X000XXXXX000XXXXX
000X000X0000000X000X000000000000000X000X
000X000X0000000X000X000000000000000X000X
000X000X0000000X000X000000000000000X000X
000XXXXX000XXXXX000X000XXXXX000XXXXXXXXX
00000000000X0000000X000X000X000X000X000X
00000000000X0000000X000X000X000X000X000X
00000000000X0000000X000X000X000X000X000X
