XXXXXXXXXXXXXXXXXXXXXXXXXXXXXXXXXXXX0000
000X00000000000X000X000X000X000000000000
000X00000000000X000X000X000X000000000000
000X00000000000X000X000X000X000000000000
XXXX000XXXXXXXXX000X000XXXXX000XXXXX000X
000000000000000X0000000X000X0000000X000X
000000000000000X0000000X000X0000000X000X
000000000000000X0000000X000X0000000X000X
XXXXXXXXXXXX000XXXXXXXXX000XXXXX000XXXXX
000X000X0000000X00000000000X00000000000X
000X000X0000000X00000000000X00000000000X
000X000X0000000X00000000000X00000000000X
000XXXXXXXXXXXXX000XXXXXXXXX000XXXXX000X
0000000X0000000X000X0000000X0000000X000X
0000000X0000000X000X0000000X0000000X000X
0000000X0000000X000X0000000X0000000X000X
XXXX000XXXXX000XXXXXXXXX000X000XXXXX000X
000X00000000000X000X00000000000X0000000X
000X00000000000X000X00000000000X0000000X
000X00000000000X000X00000000000X0000000X
XXXX000XXXXX000XXXXX000XXXXXXXXX000XXXXX
0000000X000X00000000000X00000000000X000X
0000000X000X00000000000X00000000000X000X
0000000X000X00000000000X00000000000X000X
