XXXXXXXXXXXXXXXXXXXXXXXXXXXXXXXXXXXX0000
000X0000000X0000000X0000000X000X00000000
000X0000000X0000000X0000000X000X00000000
000X0000000X0000000X0000000X000X00000000
000X000XXXXX000X000X000XXXXXXXXX000XXXXX
000X00000000000X00000000000X000X0000000X
000X00000000000X00000000000X000X0000000X
000X00000000000X00000000000X000X0000000X
XXXX000XXXXXXXXX000XXXXX000XXXXXXXXXXXXX
0000000X000X0000000X000X00000000000X000X
0000000X000X0000000X000X00000000000X000X
0000000X000X0000000X000X00000000000X000X
XXXX000XXXXX000XXXXXXXXXXXXXXXXXXXXX000X
000X0000000X000X00000000000X000X0000000X
000X0000000X000X00000000000X000X0000000X
000X0000000X000X00000000000X000X0000000X
000X000X000XXXXX000XXXXX000X000X000XXXXX
000X000X000X0000000X000X000X0000000X000X
000X000X000X0000000X000X000X0000000X000X
000X000X000X0000000X000X000X0000000X000X
XXXXXXXXXXXX000XXXXX000XXXXX000XXXXX000X
000000000000000X0000000000000000000X000X
000000000000000X0000000000000000000X000X
000000000000000X0000000000000000000X000X
