XXXXXXXXXXXXXXXXXXXXXXXXXXXXXXXXXXXX0000
00000000000000000000000X00000000000X0000
00000000000000000000000X00000000000X0000
00000000000000000000000X00000000000X0000
000XXXXXXXXXXXXX000XXXXX000X000XXXXX000X
00000000000X000X000X0000000X00000000000X
00000000000X000X000X0000000X00000000000X
00000000000X000X000X0000000X00000000000X
XXXX000X000X000XXXXX000X000XXXXXXXXXXXXX
0000000X000X00000000000X000X00000000000X
0000000X000X00000000000X000X00000000000X
0000000X000X00000000000X000X00000000000X
XXXX000X000XXXXX000XXXXXXXXXXXXX000XXXXX
0000000X000X000X000X0000000X000X0000000X
0000000X000X000X000X0000000X000X0000000X
0000000X000X000X000X0000000X000X0000000X
XXXXXXXXXXXX000X000X000XXXXX000XXXXX000X
000000000000000X0000000X000000000000000X
000000000000000X0000000X000000000000000X
000000000000000X0000000X000000000000000X
000XXXXX000XXXXXXXXXXXXX000XXXXX000X000X
0000000X000X000000000000000X0000000X000X
0000000X000X000000000000000X0000000X000X
0000000X000X000000000000000X0000000X000X
