XXXXXXXXXXXXXXXXXXXXXXXXXXXXXXXXXXXX0000
0000000X000X000X000X000000000000000X0000
0000000X000X000X000X000000000000000X0000
0000000X000X000X000X000000000000000X0000
000XXXXX000X000X000XXXXXXXXX000XXXXX000X
00000000000X00000000000X0000000X0000000X
00000000000X00000000000X0000000X0000000X
00000000000X00000000000X0000000X0000000X
XXXX000XXXXX000XXXXXXXXXXXXX000XXXXX000X
0000000X0000000X0000000X0000000X0000000X
0000000X0000000X0000000X0000000X0000000X
0000000X0000000X0000000X0000000X0000000X
000XXXXX000XXXXX000X000XXXXXXXXXXXXXXXXX
0000000X000X000X000X00000000000X000X000X
0000000X000X000X000X00000000000X000X000X
0000000X000X000X000X00000000000X000X000X
XXXX000XXXXX000XXXXXXXXXXXXX000X000X000X
0000000X00000000000X000X000X0000000X000X
0000000X00000000000X000X000X0000000X000X
0000000X00000000000X000X000X0000000X000X
XXXX000X000X000XXXXX000X000XXXXXXXXX000X
00000000000X0000000X0000000X00000000000X
00000000000X0000000X0000000X00000000000X
00000000000X0000000X0000000X00000000000X
