XXXXXXXXXXXXXXXXXXXXXXXXXXXXXXXXXXXX0000
000X00000000000X000000000000000X000X0000
000X00000000000X000000000000000X000X0000
000X00000000000X000000000000000X000X0000
XXXX000X000X000X000XXXXX000XXXXX000X000X
0000000X000X00000000000X000X0000000X000X
0000000X000X00000000000X000X0000000X000X
0000000X000X00000000000X000X0000000X000X
000XXXXXXXXX000XXXXX000XXXXX000XXXXX000X
0000000X00000000000X000X0000000X0000000X
0000000X00000000000X000X0000000X0000000X
0000000X00000000000X000X0000000X0000000X
XXXX000XXXXX000X000XXXXX000XXXXXXXXX000X
0000000X0000000X000X00000000000X000X000X
0000000X0000000X000X00000000000X000X000X
0000000X0000000X000X00000000000X000X000X
000XXXXXXXXXXXXX000X000XXXXX000XXXXX000X
000000000000000X000X000X000X00000000000X
000000000000000X000X000X000X00000000000X
000000000000000X000X000X000X00000000000X
XXXX000XXXXX000XXXXX000XXXXXXXXX000XXXXX
0000000X000X000000000000000000000000000X
0000000X000X000000000000000000000000000X
0000000X000X000000000000000000000000000X
