XXXXXXXXXXXXXXXXXXXXXXXXXXXXXXXXXXXX0000
0000000X000000000000000000000000000X0000
0000000X000000000000000000000000000X0000
0000000X000000000000000000000000000X0000
XXXX000XXXXX000XXXXX000X000XXXXXXXXX000X
000X000X0000000X0000000X000X00000000000X
000X000X0000000X0000000X000X00000000000X
000X000X0000000X0000000X000X00000000000X
000XXXXX000XXXXX000XXXXX000XXXXX000XXXXX
000000000000000X000X0000000X0000000X000X
000000000000000X000X0000000X0000000X000X
000000000000000X000X0000000X0000000X000X
XXXX000XXXXX000XXXXX000XXXXXXXXX000X000X
000X000X000X00000000000X000X000X0000000X
000X000X000X00000000000X000X000X0000000X
000X000X000X00000000000X000X000X0000000X
000X000X000X000XXXXX000X000X000X000XXXXX
000X000X000X0000000X00000000000X000X000X
000X0000000X0000000X00000000000X000X000X
000X0000000X0000000X00000000000X000X000X
000X0000000XXXXX000XXXXXXXXX000X000X000X
0000000X0000000X00000000000X00000000000X
0000000X0000000X00000000000X00000000000X
0000000X0000000X00000000000X00000000000X
