XXXXXXXXXXXXXXXXXXXXXXXXXXXXXXXXXXXX0000
000X000X00000000000X00000000000X00000000
000X000X00000000000X00000000000X00000000
000X000X00000000000X00000000000X00000000
000XXXXX000XXXXX000XXXXX000XXXXX000XXXXX
000X0000000X000X00000000000X0000000X000X
000X0000000X000X00000000000X0000000X000X
000X0000000X000X00000000000X0000000X000X
XXXX000XXXXXXXXXXXXX000XXXXX000XXXXX000X
0000000X000X000X00000000000X000X000X000X
0000000X000X000X00000000000X000X000X000X
0000000X000X000X00000000000X000X000X000X
000XXXXXXXXX000XXXXX000XXXXX000XXXXX000X
0000000X0000000X0000000X000000000000000X
0000000X0000000X0000000X000000000000000X
0000000X0000000X0000000X000000000000000X
XXXX000X000X000XXXXX000XXXXX000XXXXXXXXX
000X0000000X000X000X00000000000X0000000X
000X0000000X000X000X00000000000X0000000X
000X0000000X000X000X00000000000X0000000X
XXXX000XXXXX000X000XXXXX000XXXXX000XXXXX
0000000X0000000X0000000X00000000000X000X
0000000X0000000X0000000X00000000000X000X
0000000X0000000X0000000X00000000000X000X
