XXXXXXXXXXXXXXXXXXXXXXXXXXXXXXXXXXXX0000
00000000000X00000000000X000X000000000000
00000000000X00000000000X000X000000000000
00000000000X00000000000X000X000000000000
000XXXXX000XXXXX000X000XXXXX000XXXXXXXXX
0000000X00000000000X0000000X0000000X000X
0000000X00000000000X0000000X0000000X000X
0000000X00000000000X0000000X0000000X000X
XXXX000X000X000XXXXXXXXX000X000XXXXX000X
0000000X000X000X000X00000000000X0000000X
0000000X000X000X000X00000000000X0000000X
0000000X000X000X000X00000000000X0000000X
000XXXXX000XXXXX000X000X000XXXXX000XXXXX
000X000X00000000000X000X0000000X0000000X
000X000X00000000000X000X0000000X0000000X
000X000X00000000000X000X0000000X0000000X
000X000XXXXXXXXXXXXX000XXXXX000X000X000X
00000000000X00000000000X000X0000000X000X
00000000000X00000000000X000X0000000X000X
00000000000X00000000000X000X0000000X000X
000XXXXXXXXX000XXXXX000X000XXXXX000XXXXX
000X0000000X000X000X0000000X0000000X000X
000X0000000X000X000X0000000X0000000X000X
000X0000000X000X000X0000000X0000000X000X
