XXXXXXXXXXXXXXXXXXXXXXXXXXXXXXXXXXXX0000
00000000000X000X000000000000000X000X0000
00000000000X000X000000000000000X000X0000
00000000000X000X000000000000000X000X0000
000XXXXX000X000X000XXXXXXXXX000X000X000X
000X0000000000000000000X000X000X0000000X
000X0000000000000000000X000X000X0000000X
000X0000000000000000000X000X000X0000000X
000XXXXX000XXXXXXXXXXXXX000X000X000XXXXX
000000000000000X00000000000X0000000X000X
000000000000000X00000000000X0000000X000X
000000000000000X00000000000X0000000X000X
000XXXXXXXXX000XXXXXXXXX000XXXXXXXXX000X
000X00000000000000000000000X000X0000000X
000X00000000000000000000000X000X0000000X
000X00000000000000000000000X000X0000000X
000XXXXXXXXX000XXXXX000XXXXX000X000XXXXX
00000000000X000X0000000X000000000000000X
00000000000X000X0000000X000000000000000X
00000000000X000X0000000X000000000000000X
000XXXXXXXXX000X000X000XXXXX000XXXXX000X
000X00000000000X000X00000000000X0000000X
000X00000000000X000X00000000000X0000000X
000X00000000000X000X00000000000X0000000X
