XXXXXXXXXXXXXXXXXXXXXXXXXXXXXXXXXXXX0000
000X0000000X00000000000X00000000000X0000
000X0000000X00000000000X00000000000X0000
000X0000000X00000000000X00000000000X0000
XXXX000X000XXXXX000XXXXX000XXXXX000X000X
0000000X00000000000X0000000X000X0000000X
0000000X00000000000X0000000X000X0000000X
0000000X00000000000X0000000X000X0000000X
000XXXXX000XXXXX000X000XXXXXXXXXXXXXXXXX
000X0000000X000X0000000X0000000X000X000X
000X0000000X000X0000000X0000000X000X000X
000X0000000X000X0000000X0000000X000X000X
XXXX000XXXXXXXXXXXXXXXXX000XXXXX000XXXXX
0000000X000X0000000X0000000X000X0000000X
0000000X000X0000000X0000000X000X0000000X
0000000X000X0000000X0000000X000X0000000X
000XXXXX000X000X000X000XXXXX000XXXXX000X
000X000X0000000X0000000X0000000X0000000X
000X000X0000000X0000000X0000000X0000000X
000X000X0000000X0000000X0000000X0000000X
000X000X000XXXXXXXXX000XXXXXXXXXXXXXXXXX
000X000X000X000X000X000X0000000X000X000X
000X000X000X000X000X000X0000000X000X000X
000X000X000X000X000X000X0000000X000X000X
