XXXXXXXXXXXXXXXXXXXXXXXXXXXXXXXXXXXX0000
0000000X0000000000000000000X0000000X0000
0000000X0000000000000000000X0000000X0000
0000000X0000000000000000000X0000000X0000
000XXXXXXXXX000XXXXX000X000X000XXXXX000X
000X0000000X0000000X000X000X000X000X000X
000X0000000X0000000X000X000X000X000X000X
000X0000000X0000000X000X000X000X000X000X
000X000XXXXX000XXXXX000XXXXX000XXXXX000X
000X000X00000000000X00000000000X0000000X
000X000X00000000000X00000000000X0000000X
000X000X00000000000X00000000000X0000000X
000X000X000XXXXX000XXXXXXXXXXXXX000XXXXX
0000000X000X000X0000000X0000000X0000000X
0000000X000X000X0000000X0000000X0000000X
0000000X000X000X0000000X0000000X0000000X
000XXXXXXXXX000X000XXXXX000XXXXX000XXXXX
0000000000000000000X0000000000000000000X
0000000000000000000X0000000000000000000X
0000000000000000000X0000000000000000000X
XXXX000XXXXX000XXXXX000XXXXXXXXX000X000X
0000000X00000000000000000000000X000X000X
0000000X00000000000000000000000X000X000X
0000000X00000000000000000000000X000X000X
