XXXXXXXXXXXXXXXXXXXXXXXXXXXXXXXXXXXX0000
0000000000000000000X000X0000000X00000000
0000000000000000000X000X0000000X00000000
0000000000000000000X000X0000000X00000000
000XXXXX000XXXXX000XXXXX000X000X000XXXXX
000X0000000X000X0000000X000X00000000000X
000X0000000X000X0000000X000X00000000000X
000X0000000X000X0000000X000X00000000000X
000X000XXXXX000XXXXX000X000XXXXXXXXXXXXX
0000000X000X000X000X0000000X000X0000000X
0000000X000X000X000X0000000X000X0000000X
0000000X000X000X000X0000000X000X0000000X
XXXX000X000XXXXX000XXXXX000XXXXX000XXXXX
000X00000000000X0000000X00000000000X000X
000X00000000000X0000000X00000000000X000X
000X00000000000X0000000X00000000000X000X
XXXX000XXXXXXXXXXXXX000XXXXX000X000X000X
000000000000000000000000000X000X000X000X
000000000000000000000000000X000X000X000X
000000000000000000000000000X000X000X000X
000XXXXX000XXXXX000XXXXXXXXX000XXXXX000X
000X0000000X000X000000000000000X0000000X
000X0000000X000X000000000000000X0000000X
000X0000000X000X000000000000000X0000000X
