XXXXXXXXXXXXXXXXXXXXXXXXXXXXXXXXXXXX0000
0000000000000000000X00000000000X00000000
0000000000000000000X00000000000X00000000
0000000000000000000X00000000000X00000000
000XXXXXXXXX000XXXXXXXXX000XXXXX000XXXXX
0000000X000X0000000000000000000X000X000X
0000000X000X0000000000000000000X000X000X
0000000X000X0000000000000000000X000X000X
XXXX000XXXXX000XXXXX000XXXXX000X000XXXXX
00000000000X000X00000000000X000X0000000X
00000000000X000X00000000000X000X0000000X
00000000000X000X00000000000X000X0000000X
XXXXXXXX000X000XXXXXXXXX000X000X000XXXXX
00000000000X00000000000X000X000X0000000X
00000000000X00000000000X000X000X0000000X
00000000000X00000000000X000X000X0000000X
000X000XXXXXXXXXXXXXXXXXXXXXXXXXXXXX000X
000X00000000000X000X00000000000X0000000X
000X00000000000X000X00000000000X0000000X
000X00000000000X000X00000000000X0000000X
XXXX000XXXXX000XXXXX000XXXXX000XXXXX000X
0000000X000X000000000000000X00000000000X
0000000X000X000000000000000X00000000000X
0000000X000X000000000000000X00000000000X
