XXXXXXXXXXXXXXXXXXXXXXXXXXXXXXXXXXXX0000
00000000000X0000000X000X000X0000000X0000
0000000X000X0000000X000X000X0000000X0000
0000000X000X0000000X000X000X0000000X0000
XXXX000X000XXXXX000X000X000X000XXXXX000X
0000000X000000000000000X000000000000000X
0000000X000000000000000X000000000000000X
0000000X000000000000000X000000000000000X
000XXXXXXXXX000XXXXXXXXXXXXXXXXXXXXXXXXX
0000000X000X000X00000000000X000X000X000X
0000000X000X000X00000000000X000X000X000X
0000000X000X000X00000000000X000X000X000X
XXXX000XXXXXXXXXXXXX000XXXXX000XXXXX000X
0000000X00000000000X00000000000X0000000X
0000000X00000000000X00000000000X0000000X
0000000X00000000000X00000000000X0000000X
XXXX000XXXXX000XXXXX000XXXXXXXXX000XXXXX
0000000X0000000X00000000000X00000000000X
0000000X0000000X00000000000X00000000000X
0000000X0000000X00000000000X00000000000X
000XXXXXXXXX000XXXXX000XXXXX000XXXXX000X
000X00000000000X000X000X0000000X0000000X
000X00000000000X000X000X0000000X0000000X
000X00000000000X000X000X0000000X0000000X
